##################################
#......#.####........#.#........##
####_#.#......######.#...##.###..#
#@___#.##.##.####..#.#.####.####.#
####_#....#...##..#..######.#..#.#
#....####.###.#..#..#.........##.#
#.####....#...#.##.#..###.##.#...#
#...###.###.###......###..##.#####
###..##.......########.#.###.....#
#.##...######.#..........####.####
#..###...#....##############.....#
##..####.#.#.#...#.......##..###.#
#.#........#...###.#####...#####.#
#.###.########.....#....##......!#
#.##..##.....#.####..##..#########
#....#######.#.#....####.#....##.#
###.##.......#...####....#.##..#.#
#...##.#######.###..#.####.###...#
#.###..............##.........####
##################################