##################################
#@...............................#
#................................#
#................................#
#................................#
#................................#
#................................#
#................................#
#................................#
#................................#
#................................#
#................................#
#................................#
#................................#
#................................#
#................................#
#................................#
#................................#
#...............................!#
##################################