#################################
#...#...........................#
#...............................#
#...#...........................#
#...............................#
#..##...........................#
#...............................#
#...#...........................#
#...............................#
#...#...........................#
#...............................#
#...#...........................#
#...............................#
#...#...........................#
#...............................#
#...............................#
#...............................#
#..##...........................#
#...............................#
#################################