#################################
#.#....##$..#......#..$.#......$#
#.#.##....#.#.####...##.#.#####.#
#....######.#....##.##..#..$..###
####.#...##.####...$.##.#.###...#
#..#.###.#..#....##.....#..#.##.#
#.#.....$..$####...$.#####.####.#
#.#$##.####....#.###..........###
#....#.#.#.###.#####.####.###..##
####....$#.......#.#.##....###...
#..####.##.#####......#.##...#.##
#.#.....#....$...#####..#.$##...#
#...###.########.#.....##.##..###
###...#.......#...#.##......#.###
#...#.####.####.#.#..###.##...#.#
###.##..#......##.#.##..###.#...#
#.#.##.##.####......#..#......###
#....#.####.#.###...##.#..##....#
#.##........#.....#....##....##.#
#################################