######################################
#.....................................
#.....................................
#.....................................
#.....................................
#.....................................
#.....................................
#.....................................
#.....................................
#.....................................
#.....................................
#.....................................
#.....................................
#.....................................
#.....................................
#.....................................
#.....................................
#.....................................
#.....................................
#.....................................
#....................................#
######################################