########################################
#.#....##$..#......#..$.#......$...#...#
#.#.##....#.#.####...##.#.#####.##.#.#.#
#....######.#....##.##..#..$..#.#.####.#
####.#...##.####...$.##.#.###.#........#
#..#.###.#..#....##.....#..#.#####.#####
#.#.....$..$####...$.#####.####..#.....#
#.#$#######....#.###.#......#.##...###.#
#....#.#.#.###.#####.####.###..#.###...#
####....$#.......#.#.##.#..###.....#.###
#..####.##.#####......#.##...#.#####....
#.#.....#....$...#####..#.$###...##.....
#...###.########.#.....##.##..##...#.###
###...#.#.....#...#.##......#.####.....#
#.###.####.####.#.#..###.##...#.....##.#
#.....#.##...#..###.#..##...#.#.###.#..#
##.###..#..#...##.#.##..###.#.....#.#.##
#..##..##.####......#..#......###.#.#..#
#.##........#..#..#.#..#####.##.#....#.#
#....######.#.###...##.#..##....#.##.###
#.#.#.......#.....#....##....##.#..#...#
########################################