#################################
#.#....##$..#......#..$.#......$#
#.#.##....#.#.####...##.#.#####.#
#....######.#....##.##..#..$..###
####.#...##.####...$.##.#.###...#
#..#.###.#..#....##.....#..#.##.#
#.#.....$..$####...$.#####.####.#
#.#$##.####....#.###..........###
#....#.#.#.###.#####.####.###..##
####....$#.......#$#.##....###...
#..####.##.#####......#.##...#.##
#.#.....#....$...#####..#.$##...#
#...###.########.#.....##.##..###
###...#$......#...#.##......#.###
#$..#.####.####.#.#..###.##...#$#
###.##..#......##.#.##..###.#...#
#...##.##.####......#..#......###
#.#..#.####.#.###...##.#..##....#
#$##........#.....#$...##$...##.#
#################################