########################################
#@#....#....#......#...$#..........#...#
#.#.##...##.#.####...##.#.#####.##.#.#.#
#....######.#....##.##..#.....#.#.####.#
####.#...#..####.....##.#.###.#........#
#.$#..#.###...$#.#####.....#..#.####.###
#.#.........####.....#####.####..#.....#
#.#.#######....#.###.#......#.##...###.#
#....#.#.#.###.#####.####.###..#.###...#
####.....#.......#.#.##.#..###.....#.###
#..####.##.#####......#.##...#.#####....
#.#.....#........#####..#..###...##.....
#...###.########.#.....##.##..##...#.###
###...#.#.....#...#.##......#.####.....#
#.###.####.####.#.#..###.##...#.....##.#
#.....#.##...#..###.#..##...#.#.###.#..#
##.###..#..#...##.#.##..###.#.....#.#.##
#..##..##.####......#..#......###.#.#..#
#.##........#..#..#.#..#####.##.#....#.#
#....######.#.###...##.#..##....#.##.###
#.#.#.......#.....#....##....##.#..#...#
########################################