##################################
#................................#
#................................#
#................................#
#................................#
#................................#
#................................#
#................................#
#................................#
#................................#
#................................#
#................................#
#................................#
#................................#
#................................#
#................................#
#.......................!........#
#................................#
#................................#
##################################