##################################
#___@__#####.###....##...###...###
#_####_#...#.....###...#.....#...#
#..#.....#...###.....#.#########.#
##..####.#####.###.##..#...##.##.#
###.#.##.#.......#.##.##.###..##.#
###.#....###.#####...........#...#
#...###.##...#...########.######.#
#.#.....#..###.#....#.....#......#
#.###.##..#....####.#.###.###.####
#...#....#..###...#.#...###....#.#
###.#######.#...###.###..!.##.##.#
#.......##....##..#.###.##.##.##.#
#####.###..#####.##......#.##..#.#
#.....#...#####..##.######.##.##.#
#.#.###.#.##....##......##.......#
#.#.....#.##.##########.###.######
#.#.###..###.....##.....######...#
#.#...##.....##.....###........###
##################################