##################################
#@__#.....##.....#...##....#.#####
#_#_..###.##.###.###.#..##.#.....#
#_#.##.......#.....#.#.#...#.###.#
#_.....####.##.###.....#.##..###.#
#####.#..##.#..#.#.#####....#....#
#.###.##..#...##.####....####.####
#...#.###.######......###.......!#
#.#.........#...#.#####...######.#
#.######.##.#.#.#....##.###...#..#
#....###.#....#...##.#..##..#.#.##
###.#....####.###.####.###.##.#..#
##....##...#.......#...#.#..####.#
####.###.#.#.#####.##.##.##....#.#
#..#.....#.##......#..##.#..##.#.#
##.#####.#..###.#####..#.#.###...#
##.......#####......#.##...##.####
#..##.##.....#.####.#....#..#.##.#
#.##...#.###.....##...#####......#
##################################