##################################
#@...............................#
#................................#
#................................#
#................................#
#................................#
#................................#
#................................#
#................................#
#................................#
#................................#
#................................#
#................................#
#................................#
#................................#
#................................#
#................................#
#................................#
#................................#
##################################