##################################
#_#....##...#......##....#.......#
#_#.##....#.#.#####...##.#.#####.#
#___#######.#....##.###..#.....###
###.##...##.####......#..#.###...#
#.#..###..#..#....###....#..#..#.#
#.##....#...####......#####.####.#
#.#.##.####....#.###..........####
#....#.#.#.###.#####.####.###..###
####.....#.......#.#.##....###..!#
#..####.##.#####......#.##...#.###
#.#.....#........#####..#..##...##
#...###.########.#.....##.##..##.#
###...#...........#.##......#....#
#...#.####.####.###..###.##.#.####
###.##..#....##...#.##..###.#....#
#...##.##.###..##...#..#.....#####
#.#..#.####.#.###...##.#####....##
#.##........#.....#....#.....##..#
##################################