##################################
#@#....##...#......##....#.......#
#_#.##....#.#.#####...#.##.#####.#
#___#######.#....##.###..#.....###
###.##...##.####......##.#.###...#
#.#..###..#......####....#..#..#.#
#.##....#...####......#####.####.#
#.#.##.####....#.####.........#..#
#....#.#.#.###.#####.####.###..###
####.....#.......#.#.##....###..!#
#..####.##.#####......#.##...#.###
#.#.....#........#####..#..##...##
#...###.########.#.....##.##..##.#
###...#...........#.##......#....#
#...#.####.####.###..###.##.#.####
###.##..#....##...#.##..###.#....#
#...##.##.###..##.#.#..#.....#####
#.#..#.####.#.###...##.#####....##
#.##........#.....#....#.....##..#
##################################