##################################
#___#.....##.....#...##....#.#####
#_#_..###.##.###.###.#..##.#.....#
#_#.##.......#.....#...#...#.###.#
#_.....####.#..###....##.##..###.#
#####.#..##.#.#....#####....#....#
#.###.##..#...##..###....####.####
#...#.###.#######.....###.......!#
#.#.........#...#.#####...######.#
#.######.##.#.#.#....##.###...#..#
#....###.#....#...##.#..##..###.##
###.#....####.###.####.###.####..#
##....##...#.......#...#.#..####.#
####.###.#.#.#####.##.##.#.....#.#
#..#.....#.##......#..##.#..##.#.#
##.#####.#..###.#####..#.#.###...#
##.......#####......#.##...##.####
#..##.##.....#.####.#....#..#.##.#
#.##...#.###.....##...#####......#
##################################