##################################
#@___#....#...........#...###...##
####_##.#.##.########.#.#...#.#..#
#.##_...#.##.....####.#####.#.####
#....###.....###.#.......##.#....#
####.....####.##.#.#######..####.#
#..#.#####.##.#..#.#.....#.##....#
#.##.......##.#.##.#.###.#..#.####
#.####.###.......#.#.###.##......#
#.......##.#####..##...#.#######.#
#####.#.##...####..###.#..##.....#
#.....#.####.#...#.....#.....#####
#.###.#......#.##########.####...#
#.....#.####.#.##.......#......#.#
#.#####.#.......#.###.########.#.#
#.##.....###.##.#.###..##....###.#
#.#..####.....#.....##....##.....#
#...##....#.####.##..####.######.#
###....####..#.....#........!....#
##################################